WWWWWWWWWWWWWWWWWW
W....W....W.....GW
W.WW.W.WW.W.WWW..W
W.W..W....W...W..W
W.WWWWWWWWW.W.WW.W
WP..............GW
WWWWWWWWWWWWWWWWWW
